%%%%%%%
%o   P%
%G%%% %
%  %  %
%%  G%%
%. %%%%
%%%%%%%
