%%%%%%%%%%
%. . . .P%
%%%%%%%%%%
