%%%%%%%%%%
%.o4321.P%
%%%%%%%%%%
